SSSSSSSSSSSIIIIIIIIIIIIIIIIIIIIIIIIIIISSSSSSSSSSSS
SSSSSSSSSSSSSSIIIIIIIIIIIIIIIIIIIIIIIIIISSSSSSSSSS
SSSSSSSSSSSSIIIIIIIIIIIIIIIIIIIIIIISSSSSSSSSSSSSSS
SSSSSSSSSSSSSSSSSSSSSSSSSSSSSSSSSSSSSSSSSSSSSSSSSS
SSSSSSSSSSSSSSSSSSSSSSSSSSSSSSSSSSSSSSSSSSSSSSSSSS
SSSSSSSSSSLLLLLLLLLSSSSSSSSSSSSSSSSSSSCCCCCSSSSSSS
SSSSSSSSLLLLLLLLLLLSSSSSSSSSSSSSSSSSSSCCCCCCSSSSSS
SSSSSSSSSSLLCCCLLLLSSSSSSSSSSSSSSSSSSCCCCCCFFSSSSS
SSSSSSSSSSSLCCCCCLLSSSSSSSSSSSSSSSSSSCCCCCFFFSSSSS
SSSSSSSSSSSLCCCCCCCLSSSSSSSSSSSSCCCCCCCCCCCCCFFSSS
SSSSSSSSSSCCCCCCCLLLSSSSSSSSSSCCCCCCCCCCCCCFFFFSSS
SSSSSSSLLLLCCCCCCCLLLLSSSCCCCCCCCCCCCCCCCCFFFFFSSS
SSSLLLLLLLLCCCCCCLLLLLSSSSSSCCCCCCCCCCCCCCFFFFFSSS
SSSSSSLLLLLCCCCCCCLLLSSSSSSSSCCCCCCCCCCCCFFFFFFSSS
SSSSLLLLLLLCCCCCCCLLLSSSSSSSCCCCCCCCCCCCCFFFFFFFSS
SSSLLLLLLLLCCCCCCLLLLLSSSSSSCCCCCCCCCCCCCFFFFFFFSS
SSSSSSSSSSSCCCCCCCSSSSSSSSSSSSSSFFFFFFFFFFFFFFFFSS
SSSSSSSSSSSSCCCCCCCCSSSSSSSSSSSSSSSFFFFFFFFFFFFSSS
SSSSSSSSSSSSCCCCCCCSSSSSSSSSSSSSSSSSSSSSSFFFFFFSSS
SSSSSSSSSSSSCCCCCCCSSSSSSSSSSSSSSSSSSSSSSSSSSSSSSS
SSSSSSSSSSSSSCCCCCCSSSSSSSSSSSSSSSSSSSSSSSSSSSSSSS
SSSSSSSSSSSCCCCCCCSSSSSSSSSSSSSSSSSSSSSSSSSSSSSSSS
SSSSSSSSSSSCCCCCCSSSSSSSSSSSSSSSSSSSSSSSSSSSSSSSSS
SSSSSSSSCCCCCCCCCSSSSSSSSLLLLLLLLLLLLLLLSSSSSSSSSS
SSSSSSCCCCCCCSSSSSSSSSSSLFFFFFFFFFFFFFFLSSSSSSSSSS
SSSSSSCCCCCCCSSSSSSSSSSSSLFFFFFFFFFFFFLLSSSSSSSSSS
SSSSSSSSSSSSSSSSSSSSSSSLCCCCCCCCCCCCCCCCCCLSSSSSSS
SSSSSSSSSSSSSSSSSSSSSSSLCCCCCCCCCCCCCCCCLSSSSSSSSS
SSSSSSSSSSSSSSSSSSSSSSSSCCCCCCCCCCCCCCCCCCCCCCCSSS
SSSSSSSSSSSSSSSSSSSSSSSCCCCCCCCCCCCCCCCCCCCCCSSSSS
SSSSSSSSSSCCCCCCCCCCCCCCCCCCCCCCCCCCCCCCCCCCCSSSSS
SSSSSSSCCCCCCCCCCCCFFFFFFFFFFFFCCCCCCCCCCCCCCSSSSS
SSSSSCCCCCCCCCCCCCCFFFFFFFFFFFFCCCCCCCCCCCCCCSSSSS
SSSSSCCCCCCCCCCCCCCFFFFFFFFFFFFCCCCCCCCCCCCCSSSSSS
SSSSSCCCCCCCCCCCCCCCCCCCCCCCCCCCCCCCCCCCCCCCCCSSSS
SSSSSSSSSSSFFFFFFFFFFFFFFFFFFFFFFFFFFFFFFFFFFFSSSS
SSSSSSSSSSFFFFFFFFFFFFFFFFFFFFFFFFFFFFFFFFFFFFSSSS
SSSSSSSSSFFFFFFFFFFFFFFFFFFFFFFFFFFFFFFLLLLLLLLSSS
SSSSSSSSFFFFFFFFFFFFFFFFFFFFFFFFFFFFFLLLLLLLLLLSSS
SSSSSSSSSSSSSSSSSSSSSSSSSSSSSSSSSSSSSSSSSSSSSSSSSS
SSSSSSSSSSSSSSSSSSSSSSSSSSSSSSSSSSSSSSSSSSSSSSSSSS
SSSSSSSSSSIIIIIIIIIIIIIIIIIIIIIIIIIIIISSSSSSSSSSSS
SSSSSSSSSSSIIIIIIIIIIIIIIIIIIIIIIIIIIIIISSSSSSSSSS
SSSSSSSSSSSSSSSSSSSIIIIIIIIIIIIIIIIIIIIISSSSSSSSSS
SSSSSSSIIIIIIIIIIIIIIIIIIIIIIIIIIIIIIIIIIIIIISSSSS
SSSSSSSSSSIIIIIIIIIIIIIIIIIIIIIIIIIISSSSSSSSSSSSSS
SSSSSSSSSIIIIIIIIIIIIIIIIIIIIIIIIIIIIIIIIIIIISSSSS
SSSSSSSIIIIIIIIIIIIIIIIIIIIIIIIIIIIIIIIIIIISSSSSSS
SSSSSSSIIIIIIIIIIIIIIIIIIIIIIIIIIIIIIIIIIISSSSSSSS
SSSSSSSSSSSSSSSSSSSSSSSSSSSSSSSSSSSSSSSSSSSSSSSSSS
